R 1024 768

EA ./textures/wl.xpm

WE ./textures/erwl.xpm

       NO         ./textures/wood.xpm

SO       ./textures/ewl.xpm

S       ./textures/sprite.xpm
NT      ./validmap3.cub

F  152,  52, 0
C 102,112,                   0 
       FL         ./textures/floor2.xpm
       CL         ./textures/ceil.xpm
EN     ./textures/tatem1.xpm

MC     ./sound/Yakui.mp3

1111
1001
10E11111111111111111
1010000111111HG11111
101U1U11000001HGT001
10101000H10T11110001
1000101111A1000000U1
110AG010001H00011111
11U1101U0U11U0U11
100000100H100000111
110T001011100100GA1111
1A00002000000000111AA1
10000011101110121U00T1
1000111A001H1G1A100001
1U00U011021000G0111101
1000000000111111100001
11110111101111111U0001
10000101100000120001G1
100111H101000U100001A1
1000U1U10100T01U111111
10000100011U01101
10022100020000001
10000000011111111
1111111111