R 1024 768





EA ./textures/firewala.xpm


WE ./textures/sflr.xpm

       NO         ./textures/skin.xpm

MC    ./sound/Medoi.mp3

SO       ./textures/slime.xpm

S       ./textures/corpses.xpm
NT      none

F  152,  52, 0
C 102,112,                   0 
       FL         ./textures/toppom.xpm
       CL         ./textures/bottom.xpm
EN     ./textures/tetem1.xpm


1111111111111111111111111111111111111
1U0U000000100000000001A1000000001THT1
10000200A10000U0001111G10111020U1T0T1
1U01000111000001000000000100000011G11
10001000000111001111110101101100000U1
100T0010001000001AG0U1010A00100000111
1000000U001U00HT1G1001011111100U10001
10A10100001111111U0001000000111110001
100000010000200U11100101000U10U000001
1U0H10000010000A00000001A00010001A001
11000000200111110111110111121000111G1
10A00T100001AA10001AG000000000001UH01
100U20000A010T10001100N10101112210TU1
1101A00T0001001020001111H100000010A01
100010000001GG1000U000A1U10000TU10U01
1100001010000012011111111HG000UA10001
1A110U000000121001U00002A111111110001
1U00000100U01AG00000TT000000000000001
1G11111111111111111111111111111111111
1H1
111