R 1024 768


EN ./textures/totem1.xpm

EA ./textures/textur.xpm


WE ./textures/textur.xpm

       NO         ./textures/tex1.xpm

       FL         ./textures/basecolor.xpm
       CL         ./textures/top.xpm
SO       ./textures/tex2.xpm

S       ./textures/candlestand.xpm
NT      ./validmap2.cub

MC     ./sound/Deadline.mp3

F  152,  52, 0
C 102,112,                   0 


      1111111111111111111111111
      100000A000000000000000001
1111111000000000000000000000001
1A0111000000000011111111110T001
1001T100020000001        1A0001
1001G100U20000201    111 111001
1001H010020T00201    101   1001
10011G10T00000201    111   1001
10010011U00000001          1001         111
1U000000000000001          1001         101
10002000U000000011111111111100111       111
10020000000000000000000000000NGH1
111111111111111111110011111111111
                   1201
11111              10U1
1AGH1              1T01
1G11111111111111111100111111111
10000T0000000000T000000000000A11111111
1001000A11A0100T0001010001111A000000T1  111111111111111
10010001001010000001010111001000000001111000UU00HGAT001
10010001001010000001010101001000020001A01000UU000111111
1001U00100101000U00101000UT010002000011G1001111111
10U1110011H01110T001011111001002000000000001
1U0000000000000000010000000000U0000000000001
10111111111110111111111111111110111111111111
101         10111111110001111110111     1
1H111111111110U00000000100000000GA1111111
11111111111111111111111111111111111111111